................................
................................
................................
................................
................................
....-...........................
................................
.-----------------------------x.
._____________________________|.
._____________________________|.
._____________________________|.
._____________________________|.
.______________________________.
.______________________________.
.______________________________.
.______________..______________.
.______________________________.
.______________________________.
.______________________________.
.______________________________.
.______________________________.
.______________________________.
.______________________________.
................................
................................
................................
................................
................................
................................
................................
................................
................................