................................
......___.......................
......___.......................
......___......_................
......___.......................
......___.......................
......___.......................
.______________________________.
.______________________________.
.______________________________.
.______________________________.
.______________________________.
.______________________________.
.______________________________.
.______________________________.
.______________________________.
.______________________________.
.______________________________.
.______________________________.
.______________________________.
.______________________________.
.______________________________.
.______________________________.
................................
................................
................................
...........______..............
...........______...............
...........______...............
................................
................................
................................