................................
................................
................................
................................
................................
....-...........................
................................
.-----------------------------x.
.l____________________________r.
.l____________________________r.
.l____________________________r.
.l____________________________r.
.l____________________________r.
.l____________________________r.
.l____________________________r.
.l_____________.._____________r.
.l____________________________r.
.l____________________________r.
.l____________________________r.
.l____________________________r.
.l____________________________r.
.l____________________________r.
.bbbbbbbbbbbbbbbbbbbbbbbbbbbbbr.
................................
................................
................................
................................
................................
................................
................................
................................
................................