................................
................................
................................
................................
................................
................................
................................
.1----------------------------2.
.l____________________________r.
.l____________________________r.
.l____________________________r.
.l____________________________r.
.l____________________________r.
.l____________________________r.
.l____________________________r.
.l____________________________r.
.l____________________________r.
.l____________________________r.
.l____________________________r.
.l____________________________r.
.l____________________________r.
.l____________________________r.
.4bbbbbbbbbbbbbbbbbbbbbbbbbbbb3.
................................
................................
................................
................................
................................
................................
................................
................................
................................